

  44444444
  44444444
  33333333
  33333333
  22222222
  22222222
  11111111
  11111111